PROTEIN_TRANSLATION_protein	PROTEIN_TRANSLATION_protein; Proteasome_complex; Proteasome_degradation; PROTEIN_Proteasome_complex; PROTEIN_Proteasome_degradation
PROTEIN_co_TRANSLOC_1	PROTEIN_co_TRANSLOC_1
PROTEIN_co_TRANSLOC_2	PROTEIN_co_TRANSLOC_2; SRP; PROTEIN_SRP
PROTEIN_co_TRANSLOC_3	PROTEIN_co_TRANSLOC_3
PROTEIN_co_TRANSLOC_4	PROTEIN_co_TRANSLOC_4
PROTEIN_co_TRANSLOC_5	PROTEIN_co_TRANSLOC_5
PROTEIN_co_TRANSLOC_6	PROTEIN_co_TRANSLOC_6
PROTEIN_BiP_release	PROTEIN_BiP_release
PROTEIN_SP_degradation	PROTEIN_SP_degradation; BiP_NEF; PROTEIN_BiP_NEF
PROTEIN_PDI_1	PROTEIN_PDI_1
PROTEIN_GPI_Transfer_A1	PROTEIN_GPI_Transfer_A1
PROTEIN_GPI_Transfer_A2	PROTEIN_GPI_Transfer_A2
PROTEIN_ERNG	PROTEIN_ERNG; PROTEIN_Mannosidase_1C
PROTEIN_Mannosidase_1B_misfold	PROTEIN_Mannosidase_1B_misfold
PROTEIN_Mannosidase_1A_misfold	PROTEIN_Mannosidase_1A_misfold; PROTEIN_Mannosidase_1D_misfold; PROTEIN_OS9_recognition
PROTEIN_OS9_transfer_SYVN1	PROTEIN_OS9_transfer_SYVN1
PROTEIN_Ubiquitination_lumped	PROTEIN_Ubiquitination_lumped
PROTEIN_retro_TRANSLOC_2	PROTEIN_retro_TRANSLOC_2
PROTEIN_Ubiquitination_deglycosylation	PROTEIN_Ubiquitination_deglycosylation
PROTEIN_Ubiquitination_removal	PROTEIN_Ubiquitination_removal
PROTEIN_Ubiquitination_degradation	PROTEIN_Ubiquitination_degradation
PROTEIN_Glucosidase_1	PROTEIN_Glucosidase_1
PROTEIN_Glucosidase_2	PROTEIN_Glucosidase_2
PROTEIN_CALR_CANX_folding	PROTEIN_CALR_CANX_folding; PROTEIN_Glucosidase_3_misfolded; PROTEIN_UGGT_Refolding_1
PROTEIN_CALR_CANX_release	PROTEIN_CALR_CANX_release; PROTEIN_Glucosidase_3
PROTEIN_UGGT_Refolding_2	PROTEIN_UGGT_Refolding_2; PROTEIN_Mannosidase_1B
PROTEIN_GOLGI_MAN1A	PROTEIN_GOLGI_MAN1A
PROTEIN_GOLGI_MAN1B	PROTEIN_GOLGI_MAN1B
PROTEIN_GOLGI_MAN1C	PROTEIN_GOLGI_MAN1C
PROTEIN_GOLGI_MGAT1	PROTEIN_GOLGI_MGAT1
PROTEIN_GOLGI_MAN2	PROTEIN_GOLGI_MAN2
PROTEIN_GOLGI_MAN3	PROTEIN_GOLGI_MAN3; PROTEIN_GOLGI_MGAT2
PROTEIN_LMAN1_recognition_A	PROTEIN_LMAN1_recognition_A
PROTEIN_COPII_maturation_A	PROTEIN_COPII_maturation_A
PROTEIN_GOLGI_O_Gal	PROTEIN_GOLGI_O_Gal
PROTEIN_GOLGI_O_Core1	PROTEIN_GOLGI_O_Core1
PROTEIN_GOLGI_O_Core2	PROTEIN_GOLGI_O_Core2
PROTEIN_SECRETION_1	PROTEIN_SECRETION_1; PDI_reoxidation_GSSG; PDI_reoxidation_H2O2; PROTEIN_PDI_reoxidation_GSSG; PROTEIN_PDI_reoxidation_H2O2
PROTEIN_SECRETION_2	PROTEIN_SECRETION_2
SEC61C	SEC61C; PROTEIN_SEC61C
TRAP	TRAP; TRAP_degradation; PROTEIN_TRAP; PROTEIN_TRAP_degradation
ARF1_gdp_binding	ARF1_gdp_binding; ARF1_gdp_degradation; PROTEIN_ARF1_gdp_binding; PROTEIN_ARF1_gdp_degradation
ARF1_activation	ARF1_activation; PROTEIN_ARF1_activation
SAR1B_gdp_binding	SAR1B_gdp_binding; SAR1B_gdp_degradation; PROTEIN_SAR1B_gdp_binding; PROTEIN_SAR1B_gdp_degradation
SAR1B_activation	SAR1B_activation; PROTEIN_SAR1B_activation
RAB1A_gdp_binding	RAB1A_gdp_binding; RAB1A_gdp_degradation; PROTEIN_RAB1A_gdp_binding; PROTEIN_RAB1A_gdp_degradation
RAB6B_gdp_binding	RAB6B_gdp_binding; RAB6B_gdp_degradation; PROTEIN_RAB6B_gdp_binding; PROTEIN_RAB6B_gdp_degradation
RAB8B_gdp_binding	RAB8B_gdp_binding; RAB8B_gdp_degradation; PROTEIN_RAB8B_gdp_binding; PROTEIN_RAB8B_gdp_degradation
RAB1A_activation	RAB1A_activation; RAB6B_activation; RAB8B_activation; PROTEIN_RAB1A_activation; PROTEIN_RAB6B_activation; PROTEIN_RAB8B_activation
BiP_ATPase	BiP_ATPase; BiP_atp_formation; BiP_adp_degradation; PROTEIN_BiP_ATPase; PROTEIN_BiP_atp_formation; PROTEIN_BiP_adp_degradation
GOLGI_TO_ENDOSOME_3	GOLGI_TO_ENDOSOME_3; COPI_recycling; COPII_recycling; NSF_dissociation; SECRETION_3; PROTEIN_GOLGI_TO_ENDOSOME_3; PROTEIN_COPI_recycling; PROTEIN_COPII_recycling; PROTEIN_NSF_dissociation; PROTEIN_SECRETION_3
retro_TRANSLOC_1	retro_TRANSLOC_1; PROTEIN_retro_TRANSLOC_1
ASNA1_atp	ASNA1_atp; ASNA1_adp_degradation; ASNA1_formation; PROTEIN_ASNA1_atp; PROTEIN_ASNA1_adp_degradation; PROTEIN_ASNA1_formation
CALR_Ca2	CALR_Ca2; CALR_Ca2_degradation; PROTEIN_CALR_Ca2; PROTEIN_CALR_Ca2_degradation
PDI_reoxidation_ERO1LB	PDI_reoxidation_ERO1LB; PROTEIN_PDI_reoxidation_ERO1LB
ERO1LB_reoxidation_1	ERO1LB_reoxidation_1; PROTEIN_ERO1LB_reoxidation_1
ERO1A_reoxidation_1	ERO1A_reoxidation_1; PROTEIN_ERO1A_reoxidation_1
PDI_reoxidation_ERO1A	PDI_reoxidation_ERO1A; PROTEIN_PDI_reoxidation_ERO1A
EXOCYST_COMPLEX	EXOCYST_COMPLEX; EXOCYST_degradation; PROTEIN_EXOCYST_COMPLEX; PROTEIN_EXOCYST_degradation
SRPR	SRPR; PROTEIN_SRPR
SPC	SPC; SPC_degradation; PROTEIN_SPC; PROTEIN_SPC_degradation
co_TRANSLOC_7	co_TRANSLOC_7; PROTEIN_co_TRANSLOC_7
OST_complex	OST_complex; PROTEIN_OST_complex
PROTB_formation	PROTB_formation; PROTEIN_PROTB_formation
H2O2ter	H2O2ter; PROTEIN_H2O2ter
PROTEIN_GOLGI_TO_ENDOSOME_2	PROTEIN_GOLGI_TO_ENDOSOME_2
